Part 1: Explosion
Absentation: Relationship issues
Interdiction: End of the world prophecy
Violation: Their friends or family gi missing
Reconnaissance: They were the characters friend but betrayed them
Complicity: Friendship

Part 2: Rising Action
Villainy:  injury like broken arm
Lack: Acceptance and belonging issues
Mediation: They talk
Counteraction: Accepts them
Departure: To some cool historic place on earth
Provision or Receipt of a Magical Agent: Nothing tbey just get to live

Part 3: Climax
Guidance: Volcano
Struggle: The bad person dies but uts painful coz they were a friend
Branding: Maybe.... powers of an oracle
Victory: Their fighting skills

Part 4: Falling Action
Liquidation: By unraveling the prophecy and restoring some artifacts to their original place
Return: Regular plane flight
Pursuit: Knock them out and tie them up
Rescue: With a knife they strategically obtain they cut the ropes and fight through the bad guys

Part 5: Resolution
Unrecognized Arrival: Everyone forgot everything when he saved the world
Difficult Task: It was the whole fighting off the friend/ family villain 
Solution: Fighting 
Recognition: Video footage
Exposure: Video footage 
Transfiguration: Nothing they just get appreciation from those around them
Punishment: End of the worlx and everyone they know dies
Wedding: Acceptance from those around them