Part 1: Explosion
Absentation: They become rich.
Interdiction: A mysterious tip.
Violation: They realize their mistake.
Reconnaissance: Through other bad people and illegal networks.
Delivery: Use it against them.
Trickery: The target population.
Complicity: By misleading facts or threats.

Part 2: Rising Action
Lack: Lack of money.
Mediation: By overhearing a conversation where they owed money.
Counteraction: By offering to pay them.
Departure: In search of riches.
Provision or Receipt of a Magical Agent: Happiness to help.

Part 3: Climax
Guidance: The promise land.
Struggle: The main character wins just as the bad person was about to win.
Branding: Friends and family support.
Victory: By remembering their friends and family.

Part 4: Falling Action
Liquidation: By finding the treasure.
Return: On a horse with riches.
Pursuit: By sneaking up on them.
Rescue: By outsmarting them.

Part 5: Resolution
Unrecognized Arrival: They are top popular now.
Difficult Task: To find the lost treasure.
Solution: By setting out on the journey and using a hidden map from their uncle.
Recognition: When they became rich.
Exposure: It was obvious.
Transfiguration: Happy life.
Punishment: Makes the rest of the journey more difficult.
Wedding: Happily ever after.